------- -------
|o...........o|
|.--.|-.-|.--.|
|.--.|-.-|.--.|
|.............|
| --- --- ---.|
 ..|.......|.. 
|......|......|
|.....---.....|
|..|   |   |..|
|.---     ---.|
|..|   |   |..|
|o....-|-....o|
 ......|...... 
|..|       |..|
|.--- --- ---.|
|.............|
||...|----...||
|||..| p ...|||
------- -------
