---------------
|             |
| o........   |
| ..........  |
| .........   |
| ........ p  |
| ..........  |
|             |
|             |
             
|             |
|             |
|             |
|             |
|             |
|             |
|             |
|             |
|             |
---------------
